50 50
400 300
7     
5 173 366 173 392 339 392 339 369 334 366 
4 76 264 74 393 98 393 98 264 
4 427 160 427 328 451 328 451 160 
4 486 128 325 131 325 154 486 154 
24 212 81 212 159 187 162 181 166 180 178 167 178 167 345 190 345 191 186 209 187 209 248 235 248 236 186 303 187 303 336 329 336 329 187 349 186 349 162 326 162 325 157 324 165 236 162 235 81 
4 1 66 1 91 150 91 150 66 
4 457 1 457 97 481 97 481 1 

